"a" = (/turf/Grass,/area)
"b" = (/mob/Man{dir = 4},/turf/Grass,/area)
"c" = (/obj/MapObject/CliffTop,/obj/MapObject/Cliff{icon_state = "Cliff Back Corner Left"},/turf/Grass,/area)
"d" = (/obj/MapObject/CliffTop,/obj/MapObject/Cliff{icon_state = "Cliff Back"},/turf/Grass,/area)
"e" = (/obj/MapObject/CliffTop,/obj/MapObject/Cliff{icon_state = "Cliff Back Corner Right"},/turf/Grass,/area)
"f" = (/obj/MapObject/CliffTop,/obj/MapObject/Cliff{icon_state = "Cliff Left"},/turf/Grass,/area)
"g" = (/obj/MapObject/CliffTop,/turf/Grass,/area)
"h" = (/obj/MapObject/CliffTop,/obj/MapObject/Cliff{icon_state = "Cliff Right"},/turf/Grass,/area)
"i" = (/obj/MapObject/Cliff{icon_state = "Cliff Top Left"},/turf/Grass,/area)
"j" = (/obj/MapObject/Cliff{icon_state = "Cliff Top Middle"},/turf/Grass,/area)
"k" = (/obj/MapObject/Cliff{icon_state = "Cliff Top Right"},/turf/Grass,/area)
"l" = (/obj/MapObject/Cliff{icon_state = "Cliff Middle"},/turf/Grass,/area)
"m" = (/obj/MapObject/CliffTop,/turf/Grass,/area/Elevation/Top_BL{icon_state = "3-c"})
"n" = (/obj/MapObject/Cliff{icon_state = "Cliff Middle"},/turf/Grass,/area/Elevation/Base_TR{icon_state = "3-b"})
"o" = (/obj/MapObject/CliffTop,/obj/MapObject/Cliff{icon_state = "Cliff Right"},/turf/Grass,/area/Elevation/Base_TR{icon_state = "2-b"})
"p" = (/obj/MapObject/Cliff{icon_state = "Cliff Bottom Middle"},/turf/Grass,/area/Elevation/Base_BL{icon_state = "3"})
"q" = (/obj/MapObject/Cliff{icon_state = "Cliff Bottom Middle"},/turf/Grass,/area)
"r" = (/obj/MapObject/CliffTop,/obj/MapObject/Cliff{icon_state = "Cliff Right"},/turf/Grass,/area/Elevation/Base_TR{icon_state = "4-b"})
"s" = (/obj/MapObject/CliffTop,/obj/MapObject/Cliff{icon_state = "Cliff Left"},/obj/MapObject/Cliff{icon_state = "Cliff Left"},/turf/Grass,/area)
"t" = (/obj/MapObject/CliffTop,/obj/MapObject/Cliff{icon_state = "Cliff Left"},/turf/Grass,/area/Elevation/Top_BL{icon_state = "2-c"})
"u" = (/obj/MapObject/Cliff{icon_state = "Cliff Middle Left"},/turf/Grass,/area)
"v" = (/obj/MapObject/Cliff{icon_state = "Cliff Middle Right"},/turf/Grass,/area)
"w" = (/obj/MapObject/CliffTop,/turf/Grass,/area/Elevation/Top_BL{icon_state = "4-c"})
"x" = (/obj/MapObject/Cliff{icon_state = "Cliff Bottom Left"},/turf/Grass,/area/Elevation/Base_BL{icon_state = "2"})
"y" = (/obj/MapObject/Cliff{icon_state = "Cliff Bottom Middle"},/turf/Grass,/area/Elevation/Base_BL{icon_state = "1"})
"z" = (/obj/MapObject/Cliff{icon_state = "Cliff Middle"},/turf/Grass,/area/Elevation/Base_TR{icon_state = "1-b"})
"A" = (/obj/MapObject/Cliff{icon_state = "Cliff Bottom Right"},/turf/Grass,/area)
"B" = (/obj/MapObject/CliffTop,/turf/Grass,/area/Elevation/Top_BL{icon_state = "1-c"})
"C" = (/obj/MapObject/Cliff{icon_state = "Cliff Bottom Middle"},/turf/Grass,/area/Elevation/Base_BL{icon_state = "4"})

(1,1,1) = {"
cdddddddddddddddddddddddddddddddddddddddddddddddddddddddddddddddddddddddddddddde
fggggggggggggggggggggggggggggggggggggggggggggggggggggggggggggggggggggggggggggggh
fggggggggggggggggggggggggggggggggggggggggggggggggggggggggggggggggggggggggggggggh
fgggmggggggggggggggggggggggggggggggggggggggggggggggggggggggggggggggggggggggggggh
fgghijjjjjjjjjjjjjjjjjjjjjjjjjjjjjjjjjjjjjjjjjjjjjjjjjjjjjjjjjjjjjjjjjjjjjjkfggh
fgghllllllllllllllllllllllllllllllllllllllllllllllllllllllllllllllllllllllllfggh
fggolllllllllllllllllllllllllllllllllllllllllllllllllllllllllllllllllllllllnfggr
fgghllllllllllllllllllllllllllllllllllllllllllllllllllllllllllllllllllllllllfggh
fgghllllllllllllllllllllllllllllllllllllllllllllllllllllllllllllllllllllllllfggh
fgghpqqqqqqqqqqqqqqqqqqqqqqqqqqqqqqqqqqqqqqqqqqqqqqqqqqqqqqqqqqqqqqqqqqqqqqqfggh
fgghaaaaaaaaaaaaaaaaaaaaaaaaaaaaaaaaaaaaaaaaaaaaaaaaaaaaaaaaaaaaaaaaaaaaaaaafggh
fgghaaaaaaaaaaaaaaaaaaaaaaaaaaaaaaaaaaaaaaaaaaaaaaaaaaaaaaaaaaaaaaaaaaaaaaaafggh
fgghaaaaaaaaaaaaaaaaaaaaaaaaaaaaaaaaaaaaaaaaaaaaaaaaaaaaaaaaaaaaaaaaaaaaaaaafggh
fgghaaaaaaaaaaaaaaaaaaaaaaaaaaaaaaaaaaaaaaaaaaaaaaaaaaaaaaaaaaaaaaaaaaaaaaaafggh
fgghaaaaaaaaaaaaaaaaaaaaaaaaaaaaaaaaaaaaaaaaaaaaaaaaaaaaaaaaaaaaaaaaaaaaaaaafggh
fgghaaaaaaaaaaaaaaaaaaaaaaaaaaaaaaaaaaaaaaaaaaaaaaaaaaaaaaaaaaaaaaaaaaaaaaaafggh
fgghaaaaaaaaaaaaaaaaaaaaaaaaaaaaaaaaaaaaaaaaaaaaaaaaaaaaaaaaaaaaaaaaaaaaaaaafggh
fgghaaaaaaaaaaaaaaaaaaaaaaaaaaaaaaaaaaaaaaaaaaaaaaaaaaaaaaaaaaaaaaaaaaaaaaaafggh
fgghaaaaaaaaaaaaaaaaaaaaaaaaaaaaaaaaaaaaaaaaaaaaaaaaaaaaaaaaaaaaaaaaaaaaaaaafggh
fgghaaaaaaaaaaaaaaaaaaaaaaaaaaaaaaaaaaaaaaaaaaaaaaaaaaaaaaaaaaaaaaaaaaaaaaaafggh
fgghaaaaaaaaaaaaaaaaaaaaaaaaaaaaaaaaaaaaaaaaaaaaaaaaaaaaaaaaaaaaaaaaaaaaaaaafggh
fgghaaaaaaaaaaaaaaaaaaaaaaaaaaaaaaaaaaaaaaaaaaaaaaaaaaaaaaaaaaaaaaaaaaaaaaaafggh
fgghaaaaaaaaaaaaaaaaaaaaaaaaaaaaaaaaaaaaaaaaaaaaaaaaaaaaaaaaaaaaaaaaaaaaaaaafggh
fgghaaaaaaaaaaaaaaaaaaaaaaaaaaaaaaaaaaaaaaaaaaaaaaaaaaaaaaaaaaaaaaaaaaaaaaaafggh
fgghaaaaaaaaaaaaaaaaaaaaaaaaaaaaaaaaaaaaaaaaaaaaaaaaaaaaaaaaaaaaaaaaaaaaaaaafggh
fgghaaaaaaaaaaaaaaaaaaaaaaaaaaaaaaaaaaaaaaaaaaaaaaaaaaaaaaaaaaaaaaaaaaaaaaaafggh
fgghaaaaaaaaaaaaaaaaaaaaaaaaaaaaaaaaaaaaaaaaaaaaaaaaaaaaaaaaaaaaaaaaaaaaaaaafggh
fgghaaaaaaaaaaaaaaaaaaaaaaaaaaaaaaaaaaaaaaaaaaaaaaaaaaaaaaaaaaaaaaaaaaaaaaaafggh
fgghaaaaaaaaaaaaaaaaaaaaaaaaaaaaaaaaaaaaaaaaaaaaaaaaaaaaaaaaaaaaaaaaaaaaaaaafggh
fgghaaaaaaaaaaaaaaaaaaaaaaaaaaaaaaaaaaaaaaaaaaaaaaaaaaaaaaaaaaaaaaaaaaaaaaaafggh
fgghaaaaaaaaaaaaaaaaaaaaaaaaaaaaaaaaaaaaaaaaaaaaaaaaaaaaaaaaaaaaaaaaaaaaaaaafggh
fgghaaaaaaaaaaaaaaaaaaaaaaaaaaaaaaaaaaaaaaaaaaaaaaaaaaaaaaaaaaaaaaaaaaaaaaaafggh
fgghaaaaaaaaaaaaaaaaaaaaaaaaaaaaaaaaaaaaaaaaaaaaaaaaaaaaaaaaaaaaaaaaaaaaaaaafggh
fgghaaaaaaaaaaaaaaaaaaaaaaaaaaaaaaaaaaaaaaaaaaaaaaaaaaaaaaaaaaaaaaaaaaaaaaaafggh
fgghaaaaaaaaaaaaaaaaaaaaaaaaaaaaaaaaaaaaaaaaaaaaaaaaaaaaaaaaaaaaaaaaaaaaaaaafggh
fgghaaaaaaaaaaaaaaaaaaaaaaaaaaaaaaaaaaaaaaaaaaaaaaaaaaaaaaaaaaaaaaaaaaaaaaaafggh
fgghaaaaaaaaaaaaaaaaaaaaaaaaaaaaaaaaaaaaaaaaaaaaaaaaaaaaaaaaaaaaaaaaaaaaaaaafggh
fgghaaaaaaaaaaaaaaaaaaaaaaaaaaaaaaaaaaaaaaaaaaaaaaaaaaaaaaaaaaaaaaaaaaaaaaaafggh
fgghaaaaaaaaaaaaaaaaaaaaaaaaaaaaaaaaaaaaaaaaaaaaaaaaaaaaaaaaaaaaaaaaaaaaaaaafggh
fgghaaaaaaaaaaaaaaaaaaaaaaaaaaaaaaaaaaaaaaaaaaaaaaaaaaaaaaaaaaaaaaaaaaaaaaaafggh
fgghaaaaaaaaaaaaaaaaaaaaaaaaaaaaaaaaaaaaaaaaaaaaaaaaaaaaaaaaaaaaaaaaaaaaaaaafggh
fgghaaaaaaaaaaaaaaaaaaaaaaaaaaaaaaaaaaaaaaaaaaaaaaaaaaaaaaaaaaaaaaaaaaaaaaaafggh
fgghaaaaaaaaaaaaaaaaaaaaaaaaaaaaaaaaaaaaaaaaaaaaaaaaaaaaaaaaaaaaaaaaaaaaaaaafggh
fgghaaaaaaaaaaaaaaaaaaaaaaaaaaaaaaaaaaaaaaaaaaaaaaaaaaaaaaaaaaaaaaaaaaaaaaaafggh
fgghaaaaaaaaaaaaaaaaaaaaaaaaaaaaaaaaaaaaaaaaaaaaaaaaaaaaaaaaaaaaaaaaaaaaaaaafggh
fgghaaaaaaaaaaaaaaaaaaaaaaaaaaaaaaaaaaaaaaaaaaaaaaaaaaaaaaaaaaaaaaaaaaaaaaaafggh
fgghaaaaaaaaaaaaaaaaaaaaaaaaaaaaaaaaaaaaaaaaaaaaaaaaaaaaaaaaaaaaaaaaaaaaaaaafggh
fgghaaaaaaaaaaaaaaaaaaaaaaaaaaaaaaaaaaaaaaaaaaaaaaaaaaaaaaaaaaaaaaaaaaaaaaaafggh
fgghaaaaaaaaaaaaaaaaaaaaaaaaaaaaaaaaaaaaaaaaaaaaaaaaaaaaaaaaaaaaaaaaaaaaaaaafggh
fgghaaaaaaaaaaaaaaaaaaaaaaaaaaaaaaaaaaaaaaaaaaaaaaaaaaaaaaaaaaaaaaaaaaaaaaaafggh
fgghaaaaaaaaaaaaaaaaaaaaaaaaaaaaaaaaaaaaaaaaaaaaaaaaaaaaaaaaaaaaaaaaaaaaaaaafggh
fgghaaaaaaaaaaaaaaaaaaaaaaaaaaaaaaaaaaaaaaaaaaaaaaaaaaaaaaaaaaaaaaaaaaaaaaaafggh
fgghaaaaaaaaaaaaaaaaaaaaabaaaaaaaaaaaaaaaaaaaaaaaaaaaaaaaaaaaaaaaaaaaaaaaaaafggh
fgghaaaaaaaaaaaaaaaaaaaaaaaaaaaaaaaaaaaaaaaaaaaaaaaaaaaaaaaaaaaaaaaaaaaaaaaafggh
fgghaaaaaaaaaaaaaaaaaaaaaaaaaaaaaaaaaaaaaaaaaaaaaaaaaaaaaaaaaaaaaaaaaaaaaaaafggh
fgghaaaaaaaaaaaaaaaaaaaaaaaaaaaaaaaaaaaaaaaaaaaaaaaaaaaaaaaaaaaaaaaaaaaaaaaafggh
fgghaaaaaaaaaaaaaaaaaaaaaaaaaaaaaaaaaaaaaaaaaaaaaaaaaaaaaaaaaaaaaaaaaaaaaaaafggh
fgghaaaaaaaaaaaaaaaaaaaaaaaaaaaaaaaaaaaaaaaaaaaaaaaaaaaaaaaaaaaaaaaaaaaaaaaafggh
fgghaaaaaaaaaaaaaaaaaaaaaaaaaaaaaaaaaaaaaaaaaaaaaaaaaaaaaaaaaaaaaaaaaaaaaaaafggh
fgghaaaaaaaaaaaaaaaaaaaaaaaaaaaaaaaaaaaaaaaaaaaaaaaaaaaaaaaaaaaaaaaaaaaaaaaafggh
fgghaaaaaaaaaaaaaaaaaaaaaaaaaaaaaaaaaaaaaaaaaaaaaaaaaaaaaaaaaaaaaaaaaaaaaaaafggh
fgghaaaaaaaaaaaaaaaaaaaaaaaaaaaaaaaaaaaaaaaaaaaaaaaaaaaaaaaaaaaaaaaaaaaaaaaafggh
fgghaaaaaaaaaaaaaaaaaaaaaaaaaaaaaaaaaaaaaaaaaaaaaaaaaaaaaaaaaaaaaaaaaaaaaaaafggh
fgghaaaaaaaaaaaaaaaaaaaaaaaaaaaaaaaaaaaaaaaaaaaaaaaaaaaaaaaaaaaaaaaaaaaaaaaafggh
fgghaaaaaaaaaaaaaaaaaaaaaaaaaaaaaaaaaaaaaaaaaaaaaaaaaaaaaaaaaaaaaaaaaaaaaaaafggh
sgghaaaaaaaaaaaaaaaaaaaaaaaaaaaaaaaaaaaaaaaaaaaaaaaaaaaaaaaaaaaaaaaaaaaaaaaafggh
fgghaaaaaaaaaaaaaaaaaaaaaaaaaaaaaaaaaaaaaaaaaaaaaaaaaaaaaaaaaaaaaaaaaaaaaaaafggh
fgghaaaaaaaaaaaaaaaaaaaaaaaaaaaaaaaaaaaaaaaaaaaaaaaaaaaaaaaaaaaaaaaaaaaaaaaafggh
fgghaaaaaaaaaaaaaaaaaaaaaaaaaaaaaaaaaaaaaaaaaaaaaaaaaaaaaaaaaaaaaaaaaaaaaaaafggh
fgghaaaaaaaaaaaaaaaaaaaaaaaaaaaaaaaaaaaaaaaaaaaaaaaaaaaaaaaaaaaaaaaaaaaaaaaafggh
fgggddddddddddddddddddddddddddddddddddddddddddddddddddddddddddddddddddddddddgggh
fggggggggggggggggggggggggggggggggggggggggggggggggggggggggggggggggggggggggggggggh
sggggggggggggggggggggggggggggggggggggggggggggggggggggggggggggggggggggggggggggggh
tgggBgggggggggggggggggggggggggggggggggggggggggggggggggggggggggggggggggggggggwggh
ijjjjjjjjjjjjjjjjjjjjjjjjjjjjjjjjjjjjjjjjjjjjjjjjjjjjjjjjjjjjjjjjjjjjjjjjjjjjjjk
ullllllllllllllllllllllllllllllllllllllllllllllllllllllllllllllllllllllllllllllv
ullllllllllllllllllllllllllllllllllllllllllllllllllllllllllllllllllllllllllzlllv
ullllllllllllllllllllllllllllllllllllllllllllllllllllllllllllllllllllllllllllllv
ullllllllllllllllllllllllllllllllllllllllllllllllllllllllllllllllllllllllllllllv
xqqqyqqqqqqqqqqqqqqqqqqqqqqqqqqqqqqqqqqqqqqqqqqqqqqqqqqqqqqqqqqqqqqqqqqqqqqqCqqA
aaaaaaaaaaaaaaaaaaaaaaaaaaaaaaaaaaaaaaaaaaaaaaaaaaaaaaaaaaaaaaaaaaaaaaaaaaaaaaaa
aaaaaaaaaaaaaaaaaaaaaaaaaaaaaaaaaaaaaaaaaaaaaaaaaaaaaaaaaaaaaaaaaaaaaaaaaaaaaaaa
aaaaaaaaaaaaaaaaaaaaaaaaaaaaaaaaaaaaaaaaaaaaaaaaaaaaaaaaaaaaaaaaaaaaaaaaaaaaaaaa
aaaaaaaaaaaaaaaaaaaaaaaaaaaaaaaaaaaaaaaaaaaaaaaaaaaaaaaaaaaaaaaaaaaaaaaaaaaaaaaa
aaaaaaaaaaaaaaaaaaaaaaaaaaaaaaaaaaaaaaaaaaaaaaaaaaaaaaaaaaaaaaaaaaaaaaaaaaaaaaaa
aaaaaaaaaaaaaaaaaaaaaaaaaaaaaaaaaaaaaaaaaaaaaaaaaaaaaaaaaaaaaaaaaaaaaaaaaaaaaaaa
aaaaaaaaaaaaaaaaaaaaaaaaaaaaaaaaaaaaaaaaaaaaaaaaaaaaaaaaaaaaaaaaaaaaaaaaaaaaaaaa
aaaaaaaaaaaaaaaaaaaaaaaaaaaaaaaaaaaaaaaaaaaaaaaaaaaaaaaaaaaaaaaaaaaaaaaaaaaaaaaa
aaaaaaaaaaaaaaaaaaaaaaaaaaaaaaaaaaaaaaaaaaaaaaaaaaaaaaaaaaaaaaaaaaaaaaaaaaaaaaaa
aaaaaaaaaaaaaaaaaaaaaaaaaaaaaaaaaaaaaaaaaaaaaaaaaaaaaaaaaaaaaaaaaaaaaaaaaaaaaaaa
"}
